
NO		textures/red_wall.xpm42
SO		textures/pink_wall.xpm42
WE		textures/yellow_wall.xpm42
EA		textures/purple_wall.xpm42

F 80,80,80
C 255,110,255

1111111111111111                1111111111
1000000000000001                1000000001
100000001110000111              1000000001
10000100010100001               1000010001
10000000111000011               1000000001
1000S0000000000111111111111111111000000001
100000000000000000000000000000000000000001
111111111111111111111111111111111111111111

