NO		textures/pink_wall.xpm42
SO		textures/purple_wall.xpm42
WE		textures/yellow_wall.xpm42
EA 		textures/red_wall.xpm42
F 0,100,0
C 0,110,170


11111111111
10000000011
11000W00001
10000000011
11111011111
    101
    101
    101
1111101111111111111111
1000000000000000000001
1000000000000000000001
1000000000000000000001
1000000001110000000001
 10000000111000000001
  100000011100000001
   1000001110000001
    10000000000001
     111111111111