SO		textures/brown_brick.xpm42
WE		textures/dark_wood.xpm42
NO		textures/fence.xpm42
EA 		textures/red_brick.xpm42
F 0,100,0
C 0,110,170

11111111111111111111
1000000000W000000001
10000000000000000011
10000000000000000001
11111111110111111111
11111111111111111111

