SO	     ./path_to_the_south_texture
C	225,30,0
WE 			    ./path_to_the_west_texture
NO ./path_to_the_north_texture
EA 			 ./path_to_the_east_texture
F			255,32,54

1111111111
111110000W1111111111
111001100000000111
11111111111111111