SO	     ./path_to_the_south_texture
C	225,30,0
WE 			    ./path_to_the_west_texture
NO ./path_to_the_north_texture
EA 			 ./path_to_the_east_texture
F			255,32,54
111111111001111
1 100000111110111
11000W00111000000001
11111111111111