SO	     ./path_to_the_south_texture
C	225,30,0
WE 			    ./path_to_the_west_texture
NO ./path_to_the_north_texture
EA 			 ./path_to_the_east_texture
F			255,32,54

11
1
1
1
1
1
11111111111111111
1111 10000W111111           11111111111111
1111111100000000111
111111111111111111
1

