SO	     ./path_to_the_south_texture
C	225,30,0
WE 			    ./path_to_the_west_texture
NO ./path_to_the_north_texture
EA 			 ./path_to_the_east_texture
F			255,32,54
1
1
1
1
1
111111111111111111111
10000011111111100000011111111111
10111000000000000000000000000001111111111111111111111111111111111111111111111111111
11110011111111111111111111111111111
11110111
10000001
11111001
1100W001
11111111
11111111
10011111
10000001
11111111
1
