SO
EA
WE
NO
          11111111111111
          10000000000001
          10000000000001
          10000000000001
          11111111111111
C 100, 100, 100
F