SO	     ./path_to_the_south_texture
WE 			    ./path_to_the_west_texture
NO ./path_to_the_north_texture
EA 			 ./path_to_the_east_texture
C			230,255,255
F			85,107,47

1111111
100000111111
10000000001111111
111111110000001011
11111100000W00001111
111111111111111111
