SO	     ./path_to_the_south_texture
C	225,30,0
WE 			    ./path_to_the_west_texture
NO ./path_to_the_north_texture
EA 			 ./path_to_the_east_texture
F			255,32,54
11111111111111111111111111111111111
10000000000000000000000111111111101
10000W000100011111000000000000000011111111111
1000000011100000000111111111111101
11111111 10000000000000000000000001
11111111111111111111111111111111111111111111111111111