SO		textures/fruit-mure-violet-feuille.xpm42
WE		textures/imagesMuresRouge.xpm42
F 0,100,0
NO		textures/limonades-aux-mures-550x550.xpm42
EA 		textures/Tarte_mures.xpm42
C 0,110,170

1
1
1
1
1111111
10000N111111
1000000000111
1111000001111
1111111111111
11111111111111
1
1
1
1
1
1
1
1

