SO	     ./path_to_the_south_texture
C	225,30,0
WE 			    ./path_to_the_west_texture
NO ./path_to_the_north_texture
EA 			 ./path_to_the_east_texture
F			255,32,54

1
1
1
1
11111111111111111111111111111111
11111100000011111111100001110011111111111
1111100111000000000000000111001111111111111111111111111111111111111111111111111
1111001111111111110000001111111111111111
1111011111  1111100000111111
11110000001   10000000111111
11111111001    111111111111111111
1111100W001
111110000001111
1111110000011
111110000011
11111100001
111110000111111
100111011111111
1111110011111111
1111110001111111
111111100001111
111111110111111
1111111000111
1111111111111111111111
