SO	     ./path_to_the_south_texture
WE 			    ./path_to_the_west_texture
NO ./path_to_the_north_texture
EA 			 ./path_to_the_east_texture
C			230,255,255
F			85,107,47


11111
10001
10W01
10001
11111

1111111111111111111111111111
1000000000000000000000011111
100000W001000111110000000001
1000000011100000000111111111
1111111111000000000000000001
1111111111111111111111111111

11111111111111111111111111111111111
110000000000000000000000111111111101
11000W0001011111111000000000000000011
110000001110000000001111111111110111111
1111111111111111110000000000000000000100001
11111111111111111111111111111111111111111

11111111111111111111111111111111111
10000000000000100000000111111111101
10000W0001011111111000000000000000011111111111                        1000001
1000000011100000000111111111111101
1111111111000000000000000000000000100001
11111111111111111111111111111111111111111111111
111111111111111111111111111110001111111111111111111111
