NO		textures/red_wall.xpm42
SO		textures/pink_wall.xpm42
WE		textures/yellow_wall.xpm42
EA 		textures/purple_wall.xpm42
F 0,100,0
C 0,110,170

11111111111111111111
1000000000W000000001
10000000000000001011
10000000000000000001
11111111110111111111
11111111110111111111
10000000010100000001
10000100010100011001
10000000000000000001
11111111111111111111
