NO		textures/red_wall.xpm42
SO		textures/pink_wall.xpm42
WE		textures/yellow_wall.xpm42
EA 		textures/purple_wall.xpm42

F 0,100,0
C 0,110,170

11111111111
10000000001
111100N0001
10000000001
11111101111
     1111
