NO
SO
WE
EA
F
C
111111111111111111111
100000000000000000001
100000000000000000001
1000000000W0000000001
100000000000000000001
100000000000000000001
100000000000000000001
111111111111111111111



1111111111111111111
11111111111111111111111111111111111
10000000000000000000000111111111101
100000W00100011111000000000000000011111111111
1000000011100000000111111111111101
11111111 10000000000000000000000001
111111111111111111111111111111111111111111111

1111111
1000001
100W001
1000001
1111111

11111111
10100001
10100001
10100001
10000001
10000101
10000001
11111111	