SO		textures/colored_wall.xpm42
WE		textures/colored_wall.xpm42
NO		textures/colored_wall.xpm42
EA 		textures/colored_wall.xpm42

F 0,100,0
C 0,110,170

11111
10101
10001
10001
10001
10001
10001
10N01
10001
11111
