C	135,206,250
NO          ./path_to_the_north_texture
SO     ./path_to_the_south_texture
EA      ./path_to_the_east_texture
WE ./path_to_the_west_texture
F	144,238,144
11111111111111111111111111111111111
10000000000000100000000111111111101
10000W0001011111111000000000000000011111111111                        1000001
1000000011100000000111111111111101
11111111 1000000000000000000000000100001
11111111111111111111111111111111111111111111111
111111111111111111111111111110001111111111111111111111