NO
SO
WE
EA
F
C
111111111111111111111
100000000000000000001
100000000000000000001
1000000000W0000000001
100000000000000000001
100000000000000000001
100000000000000000001
111111111111111111111
