C	135,206,250
NO          path_NO
SO     path_SO
EA      path_EA
WE path_WE
F	144,238,144
11111111111111111111111111111111111
10000000000000000000000111111111101
10000W000100011111000000000000000011111111111
1000000011100000000111111111111101
11111111 1000000000000000000000000100001
11111111111111111111111111111111111111111111111111111