SO		textures/colored_wall.xpm42
WE		textures/colored_wall.xpm42
NO		textures/colored_wall.xpm42
EA 		textures/colored_wall.xpm42

C 0,1,156





F 0,100,0

11111111
101011
100011
100011
100111
1000111
100001
10S01
11111111
