NO 1
SO 1
WE 1
EA 1
F 1
C 1
111111111111111111111
100000000000000000001
100000000000000000001
1000000000W0000000001
100000000000000000001
100000000000000000001
100000000000000000001
111111111111111111111
