SO		./path_to_the_south_texture
WE		./path_to_the_west_texture
NO		./path_to_the_north_texture
EA 		./path_to_the_east_texture
F 0,100,0
C 0,110,170

1111111111111111111111111111
1000000000000000000000011111
100000W001000111110000000001
1000000011100000000111111111
1111111111000000000000000001
1100000000000000000000000011
1111111111111111111111111111