SO		./path_to_the_south_texture
WE		./path_to_the_west_texture
NO		./path_to_the_north_texture
EA 		./path_to_the_east_texture

F 0,100,0
C 0,110,170


11111111111111111111111111111111111
110001000000000000000000111111111101
11100E0001011111111000000000000000011
110000001110000000001111111111110111111
1111111111111111110000000000000000000100001
11111111111111111111111111111111111111111